111111111111111111111
1P0000000000000000001
100000000000000000001
111111111000111111111
100000000000000000001
100000000111111111111
1111100001C0000000001
100000000111110000001
100000000000000000001
10000000000E000000001
111111111111111111111
