111111111111111111111
100000P00000000000001
100000000000000000001
111111111000111111111
100000000000000000001
100000000111111111111
1111100001C00E0000001
100000000111110000001
100000000000000000001
100000000000000000001
111111111111111111111
