1111111111111111
1000000000000001
1P00C00C000000E1
1000000000000001
1111111111111111